111111111111111111111111
10010000000C0010000000C1
10C001111100000000000011
1P0011E00M001100000000C1
111111111111111111111111
